***************
*            R*
* ******   ** *
* ******   ** *
* *****    ** *
*         *** *
* *****   *** *
* *****   *** *
* *****   *** *
* ****    *** *
* ****    *****
*C            *
***************