******************
*                *
* ************** *
* *            * *
* * ********** * *
* * *        * * *
* * * ****** * * *
* * *    C * * * *
* * * * **** * * *
* * * *      * * *
* * * * ****** * *
* * *          * *
* * ************ *
*R*              *
******************
