***********
*        R*
* **** ** *
* **** ** *
* ***  ** *
* *** *** *
* *** *** *
* **  *** *
* **  *** *
*C        *
***********